111100010001111
121000000000121
110001000100011
100011111110001
100111111111001
100011000110001
100111000111001
110001111100011
111001111100111
111100010001111
110110000011011
120111000111021
100111111111001