000000010100000
020202010001000
000000010100000
020202010001000
000000000100000
020202000001000
000000000100000
020202000001011
000000000100010
020202000001010
000000000100000