000000010100000
020202010000000
000000010100000
020202010000000
000000000102020
020202000000000
000000000102020
020202010000000
000000010201000
020202010000000
000000010201000