000000010100000
020202010000000
000000010100000
020202010000000
000000010100000
020202010000000
000000010100000
020202010000000
000000010201000
020202010000000
000000010201000