000000010000000
020202010202020
000000010000000
020202010202020
000000010000000
020202010000020
000000010201010
020202010000000
000000010201010
020202010000000
000000010202000